.........
...X.....
.........
.........
....A....
......X..
.........
.X.......
........X
